Weakness to Frost=냉기 약화 독약
Weakness to Poison=독약 약화 독약
Weakness to Shock=쇼크 약화 독약
Weakness to Fire=화염 약화 독약
Weakness to Magic=주문 약화 독약
Waterbreathing=수중 호흡
Slow=감속 독약
Restore Stamina=회복-지구력
Restore Health=회복-체력
Restore Magicka=회복-매지카
Resist Poison=독 저항
Resist Magic=마법 저항
Resist Fire=화염 저항
Resist Frost=냉기 저항
Resist Shock=쇼크 저항
Regenerate Stamina=지구력 재생
Regenerate Health=체력 재생
Regenerate Magicka=매지카 재생
Ravage Stamina=지구력 파괴 독약
Ravage Health=체력 파괴 독약
Ravage Magicka=매지카 파괴 독약
Paralysis=마비
Lingering Damage Stamina=지속적인 지구력 피해
Lingering Damage Health=지속적인 체력 피해
Lingering Damage Magicka=지속적인 매지카 피해
Invisibility=투명 물약
Frenzy=흥분
Fortify Two-handed=양손 강화
Fortify Smithing=재련 강화
Fortify Sneak=은신 강화
Fortify Stamina=지구력 강화
Fortify Restoration=회복 강화
Fortify Pickpocket=소매치기 강화
Fortify One-handed=한손 강화
Fortify Magicka=매지카 강화
Fortify Marksman=저격 강화
Fortify Lockpicking=자물쇠 따기 강화
Fortify Light Armor=경갑 강화
Fortify Illusion=환영 강화
Fortify Health=체력 강화
Fortify Heavy Armor=중갑 강화
Fortify Enchanting=인첸트 강화
Fortify Destruction=파괴 강화
Fortify Carry Weight=운반무게 강화
Fortify Conjuration=주문력 강화
Fortify Block=방어력 강화
Fortify Barter=거래 강화
Fortify Alteration=변이 강화
Fear=공포
Damage Stamina Regen=지구력 재생력 방해 독
Damage Stamina=지구력 피해 독
Damage Magicka Regen=매지카 재생력 방해 독
Damage Magicka=매지카 피해 독
Damage Health=체력 피해 독
Cure Disease=질병 치료