Abecean Longfin=아바신 롱핀
Ancestor Moth Wing=Ancestor Moth Wing
Bear Claws=곰발톱
Bee=벌
Beehive Husk=벌집 껍질
Bleeding Crown=붉은 광대 버섯
Blisterwort=왕그물 버섯
Blue Butterfly Wing=파란 나비 날개
Blue Dartwing=파란 파리잠자리
Blue Mountain Flower=파란 들꽃
Bone Meal=뼈가루
Briar Heart=찔레 심장
Butterfly Wing=나비 날개
Canis Root=회색 뿌리
Charred Skeever Hide=그을린 스키버 가죽
Chaurus Eggs=챠루스 알
Chaurus Hunter Antennae=Chaurus Hunter Antennae
Chicken's Egg=달걀
Creep Cluster=크립 줄기
Crimson Nirnroot=크림슨 넌루트
Cyrodilic Spadetail=시로딜 변종어
Daedra Heart=데이드라 심장
Deathbell=데스벨
Dragon's Tongue=드래곤 텅
Dwarven Oil=드웨머 - 기름
Ectoplasm=심령체
Elves Ear=엘프 잎사귀
Eye of Sabre Cat=검치호랑이의 눈
Falmer Ear=팔머의 귀
Fire Salts=화염 소금
Fly Amanita=광대 버섯
Frost Mirriam=겨울초
Frost Salts=냉기 소금
Garlic=마늘
Giant Lichen=거대 이끼
Giant's Toe=거인의 발가락
Gleamblossom=Gleamblossom
Glow Dust=빛나는 가루
Glowing Mushroom=발광 버섯
Grass Pod=잔디 꼬투리
Hagraven Claw=헤그레이븐 발톱
Hagraven Feathers=헤그레이븐 깃털
Hanging Moss=늘어진 이끼
Hawk Beak=매 부리
Hawk Feathers=매 깃털
Hawk's Egg=매의 알
Histcarp=히스트 잉어
Honeycomb=꿀벌집
Human Flesh=인간의 살점
Human Heart=인간의 심장
Ice Wraith Teeth=얼음 망령 이빨
Imp Stool=임프 버섯
Jazbay Grapes=재즈베이 포도
Juniper Berries=향나무 열매
Large Antlers=큰 뿔
Lavender=라벤더
Luna Moth Wing=누에 나방 날개
Moon Sugar=문 슈거
Mora Tapinella=은행잎 버섯
Mudcrab Chitin=진흙 게 껍질
Namira's Rot=나미라의 곰팡이
Nightshade=나이트쉐이드
Nirnroot=넌루트
Nordic Barnacle=노르딕 따개비
Orange Dartwing=노란 파리잠자리
Pearl=진주
Pine Thrush Egg=개똥지빠귀 알
Poison Bloom=Poison Bloom
Powdered Mammoth Tusk=매머드 상아가루
Purple Mountain Flower=자주빛 들꽃
Red Mountain Flower=붉은 들꽃
River Betty=민물 베티
Rock Warbler Egg=바위 휘파람새 알
Sabre Cat Tooth=검치호랑이 이빨
Salmon Roe=Salmon Roe
Salt Pile=소금 가루
Scaly Pholiota=비늘 버섯
Silverside Perch=은줄 농어
Skeever Tail=스키버 꼬리
Slaughterfish Egg=식인물고기 알
Slaughterfish Scales=식인물고기 비늘
Small Antlers=작은 뿔
Small Pearl=작은 진주
Snowberries=인동딸기
Spider Egg=거미 알
Spriggan Sap=스프리건 수액
Swamp Fungal Pod=습지균 꼬투리
Taproot=곧은 뿌리
Thistle Branch=엉겅퀴 줄기
Torchbug Thorax=형광벌레 가슴
Troll Fat=트롤 지방
Tundra Cotton=툰드라 목화
Vampire Dust=흡혈귀 가루
Void Salts=공허 소금
Wheat=밀
White Cap=흰모자 버섯
Wisp Wrappings=위스피 외피
Yellow Mountain Flower=Yellow Mountain Flower
Berit's Ashes=Berit's Ashes
Farengar's Frost Salt=Farengar's Frost Salt
Fine-Cut Void Salts=Fine-Cut Void Salts
Jarrin Root=Jarrin Root